year,rank,country,gold,silver,bronz,total
1904,1,United States,78,82,79,239
1904,2,Germany,4,4,5,13
1904,3,Cuba,4,2,3,9
1904,4,Canada,4,1,1,6
1904,5,Hungary,2,1,1,4
1904,6,Great Britain,1,1,0,2
1904,6,Mixed,1,1,0,2
1904,8,Greece,1,0,1,2
1904,8,SwitzerlandÂ (SUI),1,0,1,2
1904,10,Austria,0,0,1,1
